             *
            ***
           *****
          *******
         *********
           *****
          *******
         *********
        ***********
       *************
        ***********
       *************
      ***************
     *****************
    *******************
      ***************
     *****************
    *******************
   *********************
  ***********************
    *******************
   *********************
  ***********************
 *************************
****************************